5 14
##############
#H#  ##     M#
# #          #
#    #T  ### #
##############